#######################....#######################
#................................................#
#................................................#
#...v............................................#
#................................................#
#................................................#
#................................................#
#................................................#
#................................................#
#................................................#
#................................................#
#................................................#
#................................................#
..................................................
..................................................
...............####################...............
..................................................
#................................................#
#................................................#
#................................................#
#................................................#
#................................................#
#................................................#
#................................................#
#................................................#
#................................................#
#................................................#
#................................................#
#................................................#
#######################....#######################