####################...........###################
..................................................
..................................................
....>.............................................
..................................................
####################...........###################
..................................................
..................................................
..................................................
..................................................
..................................................
####################...........###################
..................................................
..................................................
..................................................
..................................................
..................................................
####################...........###################
..................................................
..................................................
..................................................
..................................................
..................................................
####################...........###################
..................................................
..................................................
..................................................
..................................................
..................................................
####################...........###################