######################......######################
#................................................#
#................................................#
#................................................#
#................................................#
#................................................#
#................................................#
#................................................#
#.........##############################.........#
#.........#............................#.........#
#.........#............................#.........#
#.........#............................#.........#
#.........#............................#.........#
#................................................#
#........................>.......................#
#................................................#
#................................................#
#.........#............................#.........#
#.........#............................#.........#
#.........#............................#.........#
#.........#............................#.........#
#.........##############################.........#
#................................................#
#................................................#
#................................................#
#................................................#
#................................................#
#................................................#
#................................................#
######################......######################