###########################################
.......#.............#.............#.......
.......#.............#.............#.......
.......#.............#.............#.......
#.............#.............#.............#
#.............#.............#.............#
#.............#.............#.............#
.......#.............#.............#.......
.......#.............#.............#.......
.......#.............#.............#.......
#.............#.............#.............#
#.............#.............#.............#
#.............#.............#.............#
.......#.............#.............#.......
.......#.............#.............#.......
.......#.............#.............#.......
#.............#.............#.............#
#.............#.............#.............#
#.............#.............#.............#
.......#.............#.............#.......
.......#.............#.............#.......
.......#.............#.............#.......
#.............#.............#.............#
#.............#.............#.............#
#.............#.............#.............#
.......#.............#.............#.......
.......#.............#.............#..^....
.......#.............#.............#.......
###########################################